40 40 32
13 14 13 14 13 14 15 16 15 16 15 16 15 16 13 14 15 16 15 16 15 16 15 16 15 16 15 16 15 16 11 12 9 10 9 10 9 10 9 10
15 16 15 16 15 16 17 17 17 17 17 17 17 17 15 16 17 17 17 13 14 17 17 17 13 14 17 17 17 13 14 1 11 12 11 12 11 12 11 12
17 13 14 17 17 13 14 17 18 18 18 18 18 17 17 17 17 17 17 15 16 17 13 14 15 16 17 17 17 15 16 17 1 1 1 1 1 1 1 9
17 15 16 13 14 15 16 20 3 3 3 3 3 24 17 17 17 17 17 17 13 14 15 16 17 17 17 17 17 17 17 17 1 9 10 1 1 1 1 11
17 17 17 15 16 17 18 25 3 3 3 3 3 3 19 17 13 14 17 17 15 16 17 17 17 17 17 17 17 17 17 17 17 11 12 1 1 1 1 9
18 18 18 18 18 25 3 3 3 3 3 3 3 3 19 17 15 16 17 17 17 17 17 17 17 17 17 17 17 17 17 17 17 17 1 1 1 9 10 11
3 3 3 3 3 3 3 3 3 3 3 3 3 3 24 17 17 17 17 17 17 17 17 17 17 17 17 17 17 17 17 17 17 17 17 1 1 11 12 9
3 3 3 3 3 3 3 3 3 3 3 3 3 3 3 24 17 17 13 14 17 17 17 17 17 17 13 14 17 17 17 17 17 17 17 17 1 9 10 11
3 3 3 3 3 3 3 3 3 3 3 3 3 3 3 3 24 17 15 16 17 17 17 17 17 17 15 16 17 17 17 17 17 17 17 17 1 11 12 1
3 3 3 3 3 3 3 3 3 3 3 3 3 3 3 3 3 24 17 17 13 14 17 17 17 17 17 17 17 17 17 17 17 17 17 17 1 1 9 10
3 3 3 3 3 3 3 3 3 3 3 3 3 3 3 3 3 3 24 17 15 16 17 17 17 17 17 17 17 17 17 17 17 17 17 17 17 1 11 12
3 3 3 3 3 3 3 3 3 3 3 3 3 3 3 3 3 3 3 19 17 17 17 17 17 17 17 17 17 17 17 17 17 17 17 17 17 1 1 1
3 3 3 3 3 3 3 3 3 3 3 3 3 3 3 3 3 3 3 19 17 17 17 17 17 17 17 17 17 17 17 13 14 17 17 17 17 17 1 1
21 21 21 21 21 23 3 3 3 3 3 3 3 3 3 3 3 3 3 24 18 17 17 17 13 14 17 17 17 17 17 15 16 17 17 17 17 17 1 1
13 14 17 17 17 17 23 3 3 3 3 3 3 3 3 3 3 3 3 3 3 24 17 17 15 16 13 14 17 17 17 17 17 17 17 17 17 17 1 1
15 16 17 17 17 17 20 3 3 3 3 3 3 3 3 3 3 3 3 3 3 3 19 17 17 17 15 16 17 17 17 17 17 17 17 17 17 17 1 1
17 13 14 17 17 17 20 3 3 3 3 3 3 3 3 3 3 3 3 3 3 3 24 18 18 18 18 17 17 17 17 17 17 17 17 17 17 1 1 1
17 15 16 17 17 17 20 3 3 3 3 3 3 3 3 3 3 3 3 3 3 3 3 3 3 3 3 24 17 17 17 17 17 17 17 17 17 1 9 10
13 14 17 17 17 17 17 23 3 3 3 3 3 3 3 3 3 3 3 3 3 3 3 3 3 3 3 3 24 17 17 17 17 17 17 17 17 1 11 12
15 16 17 17 17 17 17 20 3 3 3 3 3 3 3 3 3 3 3 3 3 3 3 3 3 3 3 3 3 19 17 17 17 17 17 17 17 1 1 1
14 13 14 17 17 17 17 20 3 3 3 3 3 3 3 3 3 3 3 3 3 3 3 3 3 3 3 3 3 19 17 17 17 17 17 17 17 1 1 1
16 15 16 17 17 17 17 20 3 3 3 3 3 3 3 3 3 3 3 3 3 3 3 3 3 3 3 3 3 19 17 17 17 17 17 17 17 17 1 1
13 14 17 17 13 14 17 17 23 3 3 3 3 3 3 3 3 3 3 3 3 3 3 3 3 3 3 3 3 19 17 17 17 17 17 17 17 17 1 1
15 16 17 17 15 16 17 17 20 3 3 3 3 3 3 3 3 3 3 3 3 3 3 3 3 3 3 3 22 17 13 14 17 17 17 17 17 17 1 1
13 14 17 13 14 17 17 17 20 3 3 3 3 3 3 3 3 3 3 3 3 3 3 3 3 3 3 3 19 17 15 16 17 17 17 17 17 17 1 1
15 16 17 15 16 17 17 17 25 3 3 3 3 3 3 3 3 3 3 3 3 3 3 3 3 3 3 3 19 13 14 17 17 17 17 17 17 1 1 1
13 14 17 17 17 18 18 25 3 3 3 3 3 3 3 3 3 3 3 3 3 3 3 3 3 3 3 22 17 15 16 17 17 17 17 17 17 1 1 1
15 16 17 17 20 3 3 3 3 3 3 3 3 3 3 3 3 3 3 3 3 3 3 3 22 21 21 17 13 14 17 17 17 17 17 17 17 1 1 9
14 17 17 17 25 3 3 3 3 3 3 3 3 3 3 3 3 3 3 3 22 21 21 21 17 17 17 17 15 16 17 17 17 17 17 17 17 1 1 11
16 17 17 25 3 3 3 3 3 3 3 3 3 3 3 3 3 3 3 3 19 17 17 17 17 17 17 17 17 17 17 17 17 17 17 17 17 1 1 9
14 17 25 3 3 3 3 3 3 3 3 3 3 3 3 3 3 3 3 22 17 17 17 17 17 17 17 17 17 17 17 17 17 17 17 17 17 1 1 11
16 20 3 3 3 3 3 3 3 3 3 3 3 3 3 3 3 3 22 17 17 17 17 17 17 17 17 17 17 17 17 17 17 13 14 17 17 17 1 9
17 20 3 3 3 3 3 3 3 3 3 3 3 3 3 3 3 22 17 17 17 17 17 17 17 13 14 17 17 17 17 17 17 15 16 17 17 17 1 11
17 20 3 3 3 3 3 3 3 3 3 3 3 3 3 3 3 19 17 17 17 17 17 17 17 15 16 17 17 17 17 17 13 14 17 17 17 17 1 1
17 20 3 3 3 3 3 3 3 3 3 3 3 3 3 3 22 17 17 17 17 17 17 13 14 17 17 17 17 17 17 17 15 16 17 17 17 17 1 1
17 25 3 3 3 3 3 3 3 3 3 3 3 3 3 3 19 17 17 17 17 17 17 15 16 17 17 17 17 17 17 17 17 17 17 17 17 1 1 1
25 3 3 3 3 3 3 3 3 3 3 3 3 3 3 3 19 17 17 17 17 13 14 17 17 17 17 17 17 17 17 17 17 17 17 17 1 9 10 1
3 3 3 3 3 3 3 3 3 3 3 3 3 3 3 22 17 17 17 17 17 15 16 13 14 17 17 17 17 17 17 17 17 17 17 1 1 11 12 1
3 3 3 3 3 3 3 3 3 3 3 3 3 3 3 19 17 17 13 14 13 14 17 15 16 13 14 17 17 17 17 17 17 17 1 1 9 10 1 1
3 3 3 3 3 3 3 3 3 3 3 3 3 3 3 19 17 17 15 16 15 16 17 17 17 15 16 17 17 17 17 17 17 1 1 1 11 12 1 1