20 15 32
9 10 9 10 9 10 9 10 9 10 9 10 9 10 9 10 9 10 9 10
11 12 11 12 11 12 11 12 11 12 11 12 11 12 11 12 11 12 11 12
41 9 10 1 41 1 1 1 1 1 9 10 41 1 35 40 34 31 31 31
34 11 12 31 31 31 1 9 10 41 11 12 9 10 38 17 42 13 14 40
17 34 35 17 40 42 34 11 12 31 31 31 11 12 35 17 17 15 16 13
42 17 13 14 17 17 17 34 35 42 17 17 34 35 17 17 17 17 17 15
17 17 15 16 17 17 17 17 17 17 17 17 17 17 17 17 17 17 17 17
17 17 17 17 17 17 17 17 17 17 17 17 17 17 17 17 17 17 17 17
17 17 17 17 17 17 17 17 17 17 17 17 17 17 17 17 17 17 13 14
40 17 17 17 17 17 17 17 17 17 17 17 17 17 17 17 17 17 15 16
18 18 18 18 18 18 18 18 18 18 18 18 18 18 18 18 18 18 18 18
3 3 3 3 3 3 3 3 3 3 3 3 3 3 3 3 3 3 3 3
3 3 3 3 3 3 3 3 3 3 3 3 3 3 3 3 3 3 3 3
3 3 3 3 3 3 3 3 3 3 3 3 3 3 3 3 3 3 3 3
3 3 3 3 3 3 3 3 3 3 3 3 3 3 3 3 3 3 3 3