40 40 32
13 14 13 14 13 14 15 16 15 16 15 16 15 16 13 14 15 16 15 16 15 16 15 16 15 16 15 16 15 16 34 1 9 10 9 10 9 10 9 10
15 16 15 16 15 16 42 17 17 17 17 17 17 42 15 16 17 40 17 13 14 17 17 40 13 14 40 40 40 13 14 34 11 12 11 12 11 12 11 12
17 13 14 42 17 13 14 27 18 18 18 18 18 26 17 17 17 17 17 15 16 42 13 14 15 16 40 17 17 15 16 40 32 41 1 1 1 41 41 9
17 15 16 13 14 15 16 20 3 3 3 3 3 24 26 17 17 17 17 17 13 14 15 16 17 17 17 17 40 17 40 17 34 1 9 10 1 1 41 11
17 17 38 15 16 27 18 25 3 3 3 3 3 3 19 17 13 14 17 17 15 16 38 17 17 17 17 17 17 40 17 17 17 34 11 12 1 1 1 9
18 18 18 18 18 25 3 3 3 3 3 3 3 3 19 38 15 16 17 17 17 17 17 17 17 17 17 17 40 17 17 17 17 17 34 1 1 9 10 11
3 3 3 3 3 3 3 3 3 3 3 3 3 3 24 26 42 17 17 17 17 17 17 17 17 17 17 17 17 17 17 17 17 17 17 34 1 11 12 9
3 3 3 3 3 3 3 3 3 3 3 3 3 3 3 24 26 17 13 14 17 17 17 17 17 17 13 14 17 17 17 17 17 17 42 17 32 9 10 11
3 3 3 3 3 3 3 3 3 3 3 3 3 3 3 3 24 26 15 16 38 17 17 17 17 17 15 16 42 17 17 17 17 17 17 17 32 11 12 41
3 3 3 3 3 3 3 3 3 3 3 3 3 3 3 3 3 24 26 17 13 14 17 17 17 17 17 38 17 17 17 17 17 17 17 17 34 1 9 10
3 3 3 3 3 3 3 3 3 3 3 3 3 3 3 3 3 3 24 26 15 16 17 17 17 17 17 17 17 17 17 17 17 17 17 17 17 32 11 12
3 3 3 3 3 3 3 3 3 3 3 3 3 3 3 3 3 3 3 19 17 17 17 17 17 17 17 17 17 17 17 17 17 17 17 17 17 34 1 1
3 3 3 3 3 3 3 3 3 3 3 3 3 3 3 3 3 3 3 19 17 17 17 17 17 17 17 17 17 17 17 13 14 17 17 17 17 17 32 1
21 21 21 21 21 23 3 3 3 3 3 3 3 3 3 3 3 3 3 24 18 26 17 17 13 14 38 17 17 17 17 15 16 17 17 38 17 17 32 1
13 14 17 17 17 29 23 3 3 3 3 3 3 3 3 3 3 3 3 3 3 24 26 42 15 16 13 14 17 17 17 17 17 17 17 17 17 17 32 1
15 16 17 17 17 17 20 3 3 3 3 3 3 3 3 3 3 3 3 3 3 3 19 17 17 17 15 16 17 17 17 17 17 17 17 17 17 17 32 1
42 13 14 17 17 17 20 3 3 3 3 3 3 3 3 3 3 3 3 3 3 3 24 18 18 18 18 26 17 17 17 17 17 17 17 17 17 36 1 41
40 15 16 17 17 17 20 3 3 3 3 3 3 3 3 3 3 3 3 3 3 3 3 3 3 3 3 24 26 42 17 17 17 17 17 17 17 32 9 10
13 14 17 17 17 17 29 23 3 3 3 3 3 3 3 3 3 3 3 3 3 3 3 3 3 3 3 3 24 26 42 17 17 17 17 17 17 32 11 12
15 16 17 17 17 17 17 20 3 3 3 3 3 3 3 3 3 3 3 3 3 3 3 3 3 3 3 3 3 19 17 17 17 17 17 17 17 32 1 1
14 13 14 38 17 17 17 20 3 3 3 3 3 3 3 3 3 3 3 3 3 3 3 3 3 3 3 3 3 19 17 17 17 17 17 17 17 34 1 1
16 15 16 17 17 17 17 20 3 3 3 3 3 3 3 3 3 3 3 3 3 3 3 3 3 3 3 3 3 19 17 17 17 17 17 17 17 17 32 1
13 14 17 17 13 14 17 29 23 3 3 3 3 3 3 3 3 3 3 3 3 3 3 3 3 3 3 3 3 19 17 17 17 17 17 17 17 17 32 1
15 16 17 42 15 16 17 17 20 3 3 3 3 3 3 3 3 3 3 3 3 3 3 3 3 3 3 3 22 28 13 14 17 17 17 17 17 17 32 1
13 14 17 13 14 17 17 17 20 3 3 3 3 3 3 3 3 3 3 3 3 3 3 3 3 3 3 3 19 17 15 16 17 17 17 17 17 17 32 1
15 16 17 15 16 38 17 27 25 3 3 3 3 3 3 3 3 3 3 3 3 3 3 3 3 3 3 3 19 13 14 42 17 17 17 17 17 36 1 1
13 14 17 17 27 18 18 25 3 3 3 3 3 3 3 3 3 3 3 3 3 3 3 3 3 3 3 22 28 15 16 17 17 17 17 17 17 32 1 1
15 16 17 17 20 3 3 3 3 3 3 3 3 3 3 3 3 3 3 3 3 3 3 3 22 21 21 28 13 14 38 17 17 17 17 17 17 32 1 9
14 17 17 27 25 3 3 3 3 3 3 3 3 3 3 3 3 3 3 3 22 21 21 21 28 17 17 17 15 16 38 17 17 17 17 17 17 32 1 11
16 17 27 25 3 3 3 3 3 3 3 3 3 3 3 3 3 3 3 3 19 17 42 17 17 17 17 17 17 17 17 17 17 17 17 17 17 32 1 9
14 27 25 3 3 3 3 3 3 3 3 3 3 3 3 3 3 3 3 22 28 17 17 17 17 17 17 17 17 17 17 17 17 17 17 17 17 34 1 11
16 20 3 3 3 3 3 3 3 3 3 3 3 3 3 3 3 3 22 28 17 17 17 17 17 17 17 17 17 17 17 17 17 13 14 17 17 17 32 9
42 20 3 3 3 3 3 3 3 3 3 3 3 3 3 3 3 22 28 17 17 38 17 17 17 13 14 17 17 17 17 17 17 15 16 17 17 17 32 11
38 20 3 3 3 3 3 3 3 3 3 3 3 3 3 3 3 19 17 17 38 17 17 17 42 15 16 17 17 17 17 17 13 14 38 40 40 17 32 41
17 20 3 3 3 3 3 3 3 3 3 3 3 3 3 3 22 28 17 17 17 17 17 13 14 40 17 17 17 17 17 17 15 16 40 17 42 17 32 41
27 25 3 3 3 3 3 3 3 3 3 3 3 3 3 3 19 17 17 17 17 17 17 15 16 42 17 17 17 17 17 17 17 17 17 17 17 36 41 1
25 3 3 3 3 3 3 3 3 3 3 3 3 3 3 3 19 17 17 17 17 13 14 17 17 17 17 17 17 17 17 17 17 17 17 17 36 9 10 1
3 3 3 3 3 3 3 3 3 3 3 3 3 3 3 22 28 17 17 17 17 15 16 13 14 40 17 17 17 17 17 17 17 17 17 36 1 11 12 1
3 3 3 3 3 3 3 3 3 3 3 3 3 3 3 19 17 17 13 14 13 14 38 15 16 13 14 17 17 17 40 17 17 17 36 1 9 10 1 1
3 3 3 3 3 3 3 3 3 3 3 3 3 3 3 19 17 40 15 16 15 16 17 40 17 15 16 17 17 17 17 17 17 36 1 1 11 12 1 1

2 448 160 32 32 1 0
[
Hello World! This line is a whole lot longer and will hopefully be on a new line.
]

3 640 160 32 32 0 1
{
5 16
17 16
}