20 20 32
5 6 1 1 5 6 5 6 5 6 5 6 5 6 5 6 5 6 5 6
7 8 1 1 7 8 7 8 7 8 7 8 7 8 7 8 7 8 7 8
6 1 1 1 1 1 1 1 1 1 1 1 1 5 6 5 6 5 6 1
8 1 1 1 1 1 1 1 1 1 1 1 1 7 8 7 8 7 8 1
1 5 6 1 1 1 1 1 1 1 1 1 1 1 1 1 1 5 6 1
1 7 8 1 1 1 1 1 1 1 1 1 1 1 1 1 1 7 8 5
5 6 1 1 1 1 1 1 1 5 6 1 1 1 1 1 1 1 1 7
7 8 1 1 1 1 1 1 1 7 8 1 1 1 1 1 1 1 5 6
1 5 6 1 1 1 1 1 1 1 1 1 1 1 1 1 1 1 7 8
4 7 8 1 4 4 4 1 1 1 1 1 1 5 6 1 1 4 4 4
3 4 4 4 3 3 3 1 1 1 5 6 1 7 8 1 1 3 3 3
3 3 3 3 3 3 1 1 1 1 7 8 1 1 1 1 4 3 3 3
3 3 3 3 3 3 1 1 1 5 6 1 4 4 4 4 3 3 3 3
3 1 5 6 3 3 4 1 1 7 8 1 3 3 3 3 3 3 5 6
3 1 7 8 1 3 3 4 4 4 4 4 3 3 3 3 1 1 7 8
5 6 1 1 1 3 3 3 3 3 3 3 3 3 1 1 1 1 5 6
7 8 5 6 1 1 1 1 1 1 1 1 1 1 1 1 1 1 7 8
5 6 7 8 1 1 1 1 1 1 1 1 1 1 1 1 1 1 1 5
7 8 1 1 1 1 1 1 4 4 4 4 4 1 1 1 1 1 1 7
5 6 5 6 5 6 4 4 3 3 3 3 3 5 6 5 6 5 6 5

6 64 0 64 3 64 1244 res/maps/Map01.map